11111111111111
10N00000000001
10000000011111
1000000001
1111111111