1111111111
10N0000001
1000000001
1000000001
1111111111