1111111111
1000000001
1000N00011
1000000001
1111111111